ID_1,semana,s_leves,s_hosp,s_uci,s_def,s_total,pobtot,NAME_1
1,1,0,15,0,0,15,59362824.5,Andalucía
1,2,0,5,0,0,5,59362824.5,Andalucía
1,3,0,6,0,0,6,59362824.5,Andalucía
1,4,0,5,0,0,5,59362824.5,Andalucía
1,5,0,8,1,0,9,59362824.5,Andalucía
1,6,0,7,1,0,8,59362824.5,Andalucía
1,7,0,11,0,0,11,59362824.5,Andalucía
1,8,0,14,1,0,15,59362824.5,Andalucía
1,9,13,35,6,0,54,59362824.5,Andalucía
1,10,78,102,12,0,192,59362824.5,Andalucía
1,11,951,444,62,24,1481,59362824.5,Andalucía
1,12,2768,1658,194,146,4766,59362824.5,Andalucía
1,13,4011,1989,272,295,6567,59362824.5,Andalucía
1,14,2294,923,105,313,3635,59362824.5,Andalucía
1,15,1273,474,51,244,2042,59362824.5,Andalucía
1,16,685,258,28,167,1138,59362824.5,Andalucía
1,17,367,142,17,95,621,59362824.5,Andalucía
1,18,267,86,5,59,417,59362824.5,Andalucía
1,19,163,55,10,31,259,59362824.5,Andalucía
1,20,116,24,5,31,176,59362824.5,Andalucía
1,21,80,21,2,19,122,59362824.5,Andalucía
1,22,96,19,0,4,119,59362824.5,Andalucía
1,23,75,10,2,4,91,59362824.5,Andalucía
1,24,30,7,0,4,41,59362824.5,Andalucía
1,25,85,10,1,4,100,59362824.5,Andalucía
1,26,221,19,3,4,247,59362824.5,Andalucía
1,27,132,20,3,2,157,59362824.5,Andalucía
1,28,324,26,4,3,357,59362824.5,Andalucía
1,29,583,29,1,1,614,59362824.5,Andalucía
1,30,684,45,5,3,737,59362824.5,Andalucía
1,31,1355,92,9,2,1458,59362824.5,Andalucía
1,32,2294,126,17,7,2444,59362824.5,Andalucía
1,33,3921,203,21,13,4158,59362824.5,Andalucía
1,34,5001,292,24,21,5338,59362824.5,Andalucía
1,35,6690,423,42,37,7192,59362824.5,Andalucía
1,36,7187,568,58,68,7881,59362824.5,Andalucía
1,37,7699,617,61,106,8483,59362824.5,Andalucía
1,38,8589,604,61,88,9342,59362824.5,Andalucía
1,39,8272,593,48,116,9029,59362824.5,Andalucía
1,40,10231,646,50,125,11052,59362824.5,Andalucía
1,41,12790,784,52,141,13767,59362824.5,Andalucía
1,42,19494,1059,78,169,20800,59362824.5,Andalucía
1,43,26502,1481,116,260,28359,59362824.5,Andalucía
1,44,25751,1855,185,345,28136,59362824.5,Andalucía
1,45,27675,1896,191,426,30188,59362824.5,Andalucía
1,46,22316,1681,176,431,24604,59362824.5,Andalucía
1,47,14766,1319,148,393,16626,59362824.5,Andalucía
1,48,9301,876,105,326,10608,59362824.5,Andalucía
1,49,5817,596,65,230,6708,59362824.5,Andalucía
1,50,7058,549,66,161,7834,59362824.5,Andalucía
1,51,6543,509,52,152,7256,59362824.5,Andalucía
1,52,6850,483,62,119,7514,59362824.5,Andalucía
1,53,3725,131,10,38,3904,16960807,Andalucía
1,213,13957,811,81,148,14997,59362824.5,Andalucía
1,214,34290,1533,169,237,36229,59362824.5,Andalucía
1,215,44552,2483,275,423,47733,59362824.5,Andalucía
1,216,45217,3022,278,614,49131,59362824.5,Andalucía
1,217,33106,2742,267,670,36785,59362824.5,Andalucía
1,218,19767,1829,196,573,22365,59362824.5,Andalucía
1,219,10916,1139,131,362,12548,59362824.5,Andalucía
1,220,6688,789,78,312,7867,59362824.5,Andalucía
1,221,5566,611,96,243,6516,59362824.5,Andalucía
1,222,5607,551,81,149,6388,59362824.5,Andalucía
1,223,5475,558,79,131,6243,59362824.5,Andalucía
1,224,6344,507,82,77,7010,59362824.5,Andalucía
1,225,7706,589,98,93,8486,59362824.5,Andalucía
1,226,10687,795,117,64,11663,59362824.5,Andalucía
1,227,12135,849,106,93,13183,59362824.5,Andalucía
1,228,10548,869,61,89,11567,59362824.5,Andalucía
1,229,6485,452,38,31,7006,59362824.5,Andalucía
2,1,0,0,0,0,0,9315806.5,Aragón
2,2,0,1,0,0,1,9315806.5,Aragón
2,3,0,0,0,0,0,9315806.5,Aragón
2,4,0,1,0,0,1,9315806.5,Aragón
2,5,0,0,0,0,0,9315806.5,Aragón
2,6,0,2,0,0,2,9315806.5,Aragón
2,7,0,1,1,0,2,9315806.5,Aragón
2,8,1,3,2,0,6,9315806.5,Aragón
2,9,1,10,3,0,14,9315806.5,Aragón
2,10,40,30,5,5,80,9315806.5,Aragón
2,11,199,113,27,9,348,9315806.5,Aragón
2,12,802,498,83,50,1433,9315806.5,Aragón
2,13,1559,771,94,145,2569,9315806.5,Aragón
2,14,979,466,55,197,1697,9315806.5,Aragón
2,15,757,287,24,184,1252,9315806.5,Aragón
2,16,452,207,23,119,801,9315806.5,Aragón
2,17,314,131,8,75,528,9315806.5,Aragón
2,18,162,52,10,47,271,9315806.5,Aragón
2,19,140,25,4,36,205,9315806.5,Aragón
2,20,169,14,3,18,204,9315806.5,Aragón
2,21,127,16,3,9,155,9315806.5,Aragón
2,22,77,8,1,12,98,9315806.5,Aragón
2,23,63,8,0,3,74,9315806.5,Aragón
2,24,31,5,0,3,39,9315806.5,Aragón
2,25,155,5,0,2,162,9315806.5,Aragón
2,26,186,8,0,1,195,9315806.5,Aragón
2,27,194,16,3,3,216,9315806.5,Aragón
2,28,543,43,4,1,591,9315806.5,Aragón
2,29,1893,109,5,3,2010,9315806.5,Aragón
2,30,2670,233,10,14,2927,9315806.5,Aragón
2,31,3843,280,16,27,4166,9315806.5,Aragón
2,32,2922,226,11,53,3212,9315806.5,Aragón
2,33,3222,238,16,58,3534,9315806.5,Aragón
2,34,2082,240,18,58,2398,9315806.5,Aragón
2,35,1651,205,13,35,1904,9315806.5,Aragón
2,36,1737,211,7,40,1995,9315806.5,Aragón
2,37,2294,209,16,53,2572,9315806.5,Aragón
2,38,2405,231,10,52,2698,9315806.5,Aragón
2,39,2215,210,16,53,2494,9315806.5,Aragón
2,40,2193,185,11,43,2432,9315806.5,Aragón
2,41,2771,264,19,34,3088,9315806.5,Aragón
2,42,4336,334,29,54,4753,9315806.5,Aragón
2,43,7306,480,37,73,7896,9315806.5,Aragón
2,44,6516,487,45,105,7153,9315806.5,Aragón
2,45,5406,447,41,190,6084,9315806.5,Aragón
2,46,3204,326,26,180,3736,9315806.5,Aragón
2,47,2152,229,19,116,2516,9315806.5,Aragón
2,48,1902,190,26,104,2222,9315806.5,Aragón
2,49,1216,162,15,67,1460,9315806.5,Aragón
2,50,1462,166,14,79,1721,9315806.5,Aragón
2,51,1213,157,11,54,1435,9315806.5,Aragón
2,52,1510,123,18,46,1697,9315806.5,Aragón
2,53,799,48,8,14,869,2661659,Aragón
2,213,2227,150,15,36,2428,9315806.5,Aragón
2,214,4072,263,26,65,4426,9315806.5,Aragón
2,215,4731,360,25,71,5187,9315806.5,Aragón
2,216,4781,379,33,89,5282,9315806.5,Aragón
2,217,3578,309,31,90,4008,9315806.5,Aragón
2,218,2515,280,27,84,2906,9315806.5,Aragón
2,219,1539,150,17,71,1777,9315806.5,Aragón
2,220,1222,141,18,52,1433,9315806.5,Aragón
2,221,1040,135,17,35,1227,9315806.5,Aragón
2,222,824,102,16,21,963,9315806.5,Aragón
2,223,803,86,11,27,927,9315806.5,Aragón
2,224,850,83,10,16,959,9315806.5,Aragón
2,225,1041,92,13,18,1164,9315806.5,Aragón
2,226,1524,132,20,26,1702,9315806.5,Aragón
2,227,1493,160,18,22,1693,9315806.5,Aragón
2,228,1622,174,17,19,1832,9315806.5,Aragón
2,229,978,80,11,12,1081,9315806.5,Aragón
3,1,0,0,0,0,0,4076600.5,Cantabria
3,2,0,0,0,0,0,4076600.5,Cantabria
3,3,0,0,0,0,0,4076600.5,Cantabria
3,4,0,0,0,0,0,4076600.5,Cantabria
3,5,0,0,0,0,0,4076600.5,Cantabria
3,6,0,0,0,0,0,4076600.5,Cantabria
3,7,0,0,0,0,0,4076600.5,Cantabria
3,8,0,0,0,0,0,4076600.5,Cantabria
3,9,10,0,0,0,10,4076600.5,Cantabria
3,10,2,0,0,0,2,4076600.5,Cantabria
3,11,67,8,0,1,76,4076600.5,Cantabria
3,12,452,43,16,16,527,4076600.5,Cantabria
3,13,705,62,18,43,828,4076600.5,Cantabria
3,14,350,89,6,40,485,4076600.5,Cantabria
3,15,239,82,5,42,368,4076600.5,Cantabria
3,16,190,32,0,33,255,4076600.5,Cantabria
3,17,132,18,0,20,170,4076600.5,Cantabria
3,18,66,3,0,9,78,4076600.5,Cantabria
3,19,46,8,0,3,57,4076600.5,Cantabria
3,20,22,3,0,4,29,4076600.5,Cantabria
3,21,22,4,0,0,26,4076600.5,Cantabria
3,22,17,3,0,0,20,4076600.5,Cantabria
3,23,8,3,1,0,12,4076600.5,Cantabria
3,24,14,2,0,0,16,4076600.5,Cantabria
3,25,13,2,0,1,16,4076600.5,Cantabria
3,26,12,3,0,0,15,4076600.5,Cantabria
3,27,5,0,0,0,5,4076600.5,Cantabria
3,28,10,1,0,0,11,4076600.5,Cantabria
3,29,28,4,1,0,33,4076600.5,Cantabria
3,30,42,3,0,0,45,4076600.5,Cantabria
3,31,155,15,2,0,172,4076600.5,Cantabria
3,32,220,22,3,3,248,4076600.5,Cantabria
3,33,361,23,1,0,385,4076600.5,Cantabria
3,34,458,35,3,1,497,4076600.5,Cantabria
3,35,661,31,2,3,697,4076600.5,Cantabria
3,36,732,26,5,3,766,4076600.5,Cantabria
3,37,834,54,2,2,892,4076600.5,Cantabria
3,38,551,41,4,6,602,4076600.5,Cantabria
3,39,373,35,8,2,418,4076600.5,Cantabria
3,40,321,27,6,2,356,4076600.5,Cantabria
3,41,355,26,5,3,389,4076600.5,Cantabria
3,42,696,55,8,5,764,4076600.5,Cantabria
3,43,1150,84,8,5,1247,4076600.5,Cantabria
3,44,1338,138,13,12,1501,4076600.5,Cantabria
3,45,1576,142,28,16,1762,4076600.5,Cantabria
3,46,1528,132,14,19,1693,4076600.5,Cantabria
3,47,1063,114,13,12,1202,4076600.5,Cantabria
3,48,825,113,13,24,975,4076600.5,Cantabria
3,49,745,81,12,22,860,4076600.5,Cantabria
3,50,515,89,10,22,636,4076600.5,Cantabria
3,51,428,50,7,17,502,4076600.5,Cantabria
3,52,514,36,10,9,569,4076600.5,Cantabria
3,53,147,22,1,7,177,1164743,Cantabria
3,213,929,73,11,10,1023,4076600.5,Cantabria
3,214,1032,124,14,11,1181,4076600.5,Cantabria
3,215,1182,143,11,16,1352,4076600.5,Cantabria
3,216,1112,151,29,30,1322,4076600.5,Cantabria
3,217,921,86,15,15,1037,4076600.5,Cantabria
3,218,572,75,11,12,670,4076600.5,Cantabria
3,219,485,75,11,9,580,4076600.5,Cantabria
3,220,391,80,14,7,492,4076600.5,Cantabria
3,221,292,38,12,7,349,4076600.5,Cantabria
3,222,267,49,7,12,335,4076600.5,Cantabria
3,223,298,46,7,2,353,4076600.5,Cantabria
3,224,335,40,7,3,385,4076600.5,Cantabria
3,225,381,62,10,2,455,4076600.5,Cantabria
3,226,459,41,10,3,513,4076600.5,Cantabria
3,227,617,78,13,5,713,4076600.5,Cantabria
3,228,734,66,11,3,814,4076600.5,Cantabria
3,229,625,74,9,2,710,4076600.5,Cantabria
4,1,0,0,0,0,0,14310436,Castilla-La Mancha
4,2,0,0,0,0,0,14310436,Castilla-La Mancha
4,3,0,0,0,0,0,14310436,Castilla-La Mancha
4,4,0,0,0,0,0,14310436,Castilla-La Mancha
4,5,0,0,0,0,0,14310436,Castilla-La Mancha
4,6,0,0,0,0,0,14310436,Castilla-La Mancha
4,7,0,0,0,0,0,14310436,Castilla-La Mancha
4,8,0,3,2,0,5,14310436,Castilla-La Mancha
4,9,9,17,2,0,28,14310436,Castilla-La Mancha
4,10,68,98,11,2,179,14310436,Castilla-La Mancha
4,11,842,714,63,69,1688,14310436,Castilla-La Mancha
4,12,2615,2174,143,367,5299,14310436,Castilla-La Mancha
4,13,4332,2527,156,663,7678,14310436,Castilla-La Mancha
4,14,3643,1655,65,543,5906,14310436,Castilla-La Mancha
4,15,1791,884,27,418,3120,14310436,Castilla-La Mancha
4,16,1160,548,18,309,2035,14310436,Castilla-La Mancha
4,17,592,267,4,181,1044,14310436,Castilla-La Mancha
4,18,219,120,5,124,468,14310436,Castilla-La Mancha
4,19,110,26,1,91,228,14310436,Castilla-La Mancha
4,20,315,39,2,47,403,14310436,Castilla-La Mancha
4,21,279,35,4,37,355,14310436,Castilla-La Mancha
4,22,305,33,4,19,361,14310436,Castilla-La Mancha
4,23,269,30,4,7,310,14310436,Castilla-La Mancha
4,24,129,14,2,5,150,14310436,Castilla-La Mancha
4,25,132,13,0,2,147,14310436,Castilla-La Mancha
4,26,152,31,2,9,194,14310436,Castilla-La Mancha
4,27,151,30,1,2,184,14310436,Castilla-La Mancha
4,28,148,38,3,4,193,14310436,Castilla-La Mancha
4,29,153,21,2,4,180,14310436,Castilla-La Mancha
4,30,221,10,1,1,233,14310436,Castilla-La Mancha
4,31,365,14,1,6,386,14310436,Castilla-La Mancha
4,32,757,32,5,6,800,14310436,Castilla-La Mancha
4,33,1340,37,2,6,1385,14310436,Castilla-La Mancha
4,34,2306,59,6,10,2381,14310436,Castilla-La Mancha
4,35,3113,106,8,11,3238,14310436,Castilla-La Mancha
4,36,4055,134,11,22,4222,14310436,Castilla-La Mancha
4,37,4777,195,19,52,5043,14310436,Castilla-La Mancha
4,38,5181,196,20,58,5455,14310436,Castilla-La Mancha
4,39,4637,226,18,61,4942,14310436,Castilla-La Mancha
4,40,4091,241,23,61,4416,14310436,Castilla-La Mancha
4,41,4110,242,21,68,4441,14310436,Castilla-La Mancha
4,42,5066,231,17,62,5376,14310436,Castilla-La Mancha
4,43,6719,331,21,86,7157,14310436,Castilla-La Mancha
4,44,6497,344,34,118,6993,14310436,Castilla-La Mancha
4,45,5945,337,24,110,6416,14310436,Castilla-La Mancha
4,46,4752,317,30,128,5227,14310436,Castilla-La Mancha
4,47,3313,217,24,107,3661,14310436,Castilla-La Mancha
4,48,2736,198,29,77,3040,14310436,Castilla-La Mancha
4,49,2499,165,10,72,2746,14310436,Castilla-La Mancha
4,50,3335,200,20,91,3646,14310436,Castilla-La Mancha
4,51,3797,201,28,64,4090,14310436,Castilla-La Mancha
4,52,4162,255,24,70,4511,14310436,Castilla-La Mancha
4,53,2408,85,5,23,2521,4088696,Castilla-La Mancha
4,213,7747,313,27,69,8156,14310436,Castilla-La Mancha
4,214,14076,566,43,129,14814,14310436,Castilla-La Mancha
4,215,16529,855,70,216,17670,14310436,Castilla-La Mancha
4,216,13288,704,84,257,14333,14310436,Castilla-La Mancha
4,217,7588,472,58,246,8364,14310436,Castilla-La Mancha
4,218,3639,229,28,184,4080,14310436,Castilla-La Mancha
4,219,1655,114,11,110,1890,14310436,Castilla-La Mancha
4,220,1063,61,10,62,1196,14310436,Castilla-La Mancha
4,221,915,54,8,40,1017,14310436,Castilla-La Mancha
4,222,884,61,6,22,973,14310436,Castilla-La Mancha
4,223,884,60,2,24,970,14310436,Castilla-La Mancha
4,224,1090,55,7,16,1168,14310436,Castilla-La Mancha
4,225,1562,89,6,20,1677,14310436,Castilla-La Mancha
4,226,1969,110,11,20,2110,14310436,Castilla-La Mancha
4,227,2361,85,12,34,2492,14310436,Castilla-La Mancha
4,228,2356,70,7,24,2457,14310436,Castilla-La Mancha
4,229,1484,9,1,4,1498,14310436,Castilla-La Mancha
5,1,0,0,0,0,0,16774320.5,Castilla y León
5,2,0,0,0,0,0,16774320.5,Castilla y León
5,3,0,1,0,0,1,16774320.5,Castilla y León
5,4,0,1,0,0,1,16774320.5,Castilla y León
5,5,2,6,0,0,8,16774320.5,Castilla y León
5,6,0,4,0,0,4,16774320.5,Castilla y León
5,7,0,2,0,0,2,16774320.5,Castilla y León
5,8,1,6,2,0,9,16774320.5,Castilla y León
5,9,16,20,2,0,38,16774320.5,Castilla y León
5,10,60,68,5,0,133,16774320.5,Castilla y León
5,11,714,430,52,30,1226,16774320.5,Castilla y León
5,12,2835,1602,157,242,4836,16774320.5,Castilla y León
5,13,4349,2152,156,507,7164,16774320.5,Castilla y León
5,14,3378,1262,73,532,5245,16774320.5,Castilla y León
5,15,3494,744,37,465,4740,16774320.5,Castilla y León
5,16,1904,580,11,323,2818,16774320.5,Castilla y León
5,17,1441,355,15,243,2054,16774320.5,Castilla y León
5,18,635,196,13,165,1009,16774320.5,Castilla y León
5,19,447,117,5,101,670,16774320.5,Castilla y León
5,20,340,71,0,42,453,16774320.5,Castilla y León
5,21,330,61,0,44,435,16774320.5,Castilla y León
5,22,335,45,5,49,434,16774320.5,Castilla y León
5,23,240,46,2,34,322,16774320.5,Castilla y León
5,24,150,37,2,28,217,16774320.5,Castilla y León
5,25,120,25,5,24,174,16774320.5,Castilla y León
5,26,99,23,2,13,137,16774320.5,Castilla y León
5,27,57,8,0,6,71,16774320.5,Castilla y León
5,28,74,9,0,3,86,16774320.5,Castilla y León
5,29,128,21,2,2,153,16774320.5,Castilla y León
5,30,208,20,2,1,231,16774320.5,Castilla y León
5,31,625,40,0,2,667,16774320.5,Castilla y León
5,32,1313,68,2,4,1387,16774320.5,Castilla y León
5,33,1725,108,9,5,1847,16774320.5,Castilla y León
5,34,2560,176,13,15,2764,16774320.5,Castilla y León
5,35,2868,227,20,34,3149,16774320.5,Castilla y León
5,36,3639,229,21,29,3918,16774320.5,Castilla y León
5,37,4735,319,23,44,5121,16774320.5,Castilla y León
5,38,5016,436,41,59,5552,16774320.5,Castilla y León
5,39,5087,486,46,77,5696,16774320.5,Castilla y León
5,40,4825,498,47,107,5477,16774320.5,Castilla y León
5,41,5856,615,48,119,6638,16774320.5,Castilla y León
5,42,8123,802,63,130,9118,16774320.5,Castilla y León
5,43,11058,899,54,151,12162,16774320.5,Castilla y León
5,44,11062,1001,74,183,12320,16774320.5,Castilla y León
5,45,11729,1048,85,251,13113,16774320.5,Castilla y León
5,46,9262,917,75,262,10516,16774320.5,Castilla y León
5,47,5647,654,54,224,6579,16774320.5,Castilla y León
5,48,3535,491,39,164,4229,16774320.5,Castilla y León
5,49,2019,356,23,172,2570,16774320.5,Castilla y León
5,50,2285,310,23,127,2745,16774320.5,Castilla y León
5,51,1765,270,23,85,2143,16774320.5,Castilla y León
5,52,1748,194,22,83,2047,16774320.5,Castilla y León
5,53,989,70,8,15,1082,4792663,Castilla y León
5,213,4829,329,40,67,5265,16774320.5,Castilla y León
5,214,11969,650,63,77,12759,16774320.5,Castilla y León
5,215,17364,1239,104,135,18842,16774320.5,Castilla y León
5,216,16180,1445,114,204,17943,16774320.5,Castilla y León
5,217,10361,1165,101,231,11858,16774320.5,Castilla y León
5,218,5084,740,56,200,6080,16774320.5,Castilla y León
5,219,2804,400,37,133,3374,16774320.5,Castilla y León
5,220,1824,312,22,93,2251,16774320.5,Castilla y León
5,221,1458,203,24,81,1766,16774320.5,Castilla y León
5,222,1237,183,12,52,1484,16774320.5,Castilla y León
5,223,1295,181,21,54,1551,16774320.5,Castilla y León
5,224,1446,190,19,41,1696,16774320.5,Castilla y León
5,225,1955,213,18,32,2218,16774320.5,Castilla y León
5,226,2487,245,33,31,2796,16774320.5,Castilla y León
5,227,2375,263,23,26,2687,16774320.5,Castilla y León
5,228,2403,231,20,30,2684,16774320.5,Castilla y León
5,229,1771,133,9,12,1925,16774320.5,Castilla y León
6,1,0,58,0,0,58,53577454,Cataluña
6,2,0,9,1,0,10,53577454,Cataluña
6,3,0,10,1,0,11,53577454,Cataluña
6,4,0,9,0,0,9,53577454,Cataluña
6,5,0,40,0,0,40,53577454,Cataluña
6,6,0,27,0,0,27,53577454,Cataluña
6,7,1,41,0,0,42,53577454,Cataluña
6,8,1,78,4,0,83,53577454,Cataluña
6,9,22,113,5,0,140,53577454,Cataluña
6,10,115,304,26,4,449,53577454,Cataluña
6,11,2734,1478,174,82,4468,53577454,Cataluña
6,12,8672,4317,483,609,14081,53577454,Cataluña
6,13,11024,4898,385,1315,17622,53577454,Cataluña
6,14,8168,3177,249,1192,12786,53577454,Cataluña
6,15,6289,2046,118,1045,9498,53577454,Cataluña
6,16,6033,1157,51,799,8040,53577454,Cataluña
6,17,2981,565,36,543,4125,53577454,Cataluña
6,18,1215,333,14,396,1958,53577454,Cataluña
6,19,941,180,12,211,1344,53577454,Cataluña
6,20,1424,117,6,105,1652,53577454,Cataluña
6,21,1852,97,5,91,2045,53577454,Cataluña
6,22,1078,72,3,51,1204,53577454,Cataluña
6,23,992,83,3,31,1109,53577454,Cataluña
6,24,741,31,8,23,803,53577454,Cataluña
6,25,646,34,2,10,692,53577454,Cataluña
6,26,845,34,4,8,891,53577454,Cataluña
6,27,1602,64,7,7,1680,53577454,Cataluña
6,28,3336,84,6,6,3432,53577454,Cataluña
6,29,5945,119,8,16,6088,53577454,Cataluña
6,30,6564,150,15,30,6759,53577454,Cataluña
6,31,6656,193,21,35,6905,53577454,Cataluña
6,32,6373,212,20,37,6642,53577454,Cataluña
6,33,6865,203,16,41,7125,53577454,Cataluña
6,34,7563,213,22,53,7851,53577454,Cataluña
6,35,7656,225,21,44,7946,53577454,Cataluña
6,36,7088,269,19,45,7421,53577454,Cataluña
6,37,6800,272,23,57,7152,53577454,Cataluña
6,38,7754,260,29,59,8102,53577454,Cataluña
6,39,7209,286,18,77,7590,53577454,Cataluña
6,40,10060,386,35,81,10562,53577454,Cataluña
6,41,13683,512,34,96,14325,53577454,Cataluña
6,42,24727,725,73,141,25666,53577454,Cataluña
6,43,33693,894,82,228,34897,53577454,Cataluña
6,44,29695,1053,66,370,31184,53577454,Cataluña
6,45,22326,915,78,438,23757,53577454,Cataluña
6,46,14668,842,67,394,15971,53577454,Cataluña
6,47,9628,605,52,295,10580,53577454,Cataluña
6,48,8257,476,33,314,9080,53577454,Cataluña
6,49,6558,380,27,245,7210,53577454,Cataluña
6,50,11215,411,32,227,11885,53577454,Cataluña
6,51,13384,450,30,205,14069,53577454,Cataluña
6,52,15072,590,46,240,15948,53577454,Cataluña
6,53,7366,192,19,81,7658,15307844,Cataluña
6,213,18522,713,63,303,19601,53577454,Cataluña
6,214,27731,910,67,381,29089,53577454,Cataluña
6,215,24566,1060,101,439,26166,53577454,Cataluña
6,216,21290,839,87,500,22716,53577454,Cataluña
6,217,16828,715,58,434,18035,53577454,Cataluña
6,218,11918,538,53,339,12848,53577454,Cataluña
6,219,9672,418,34,254,10378,53577454,Cataluña
6,220,8607,387,28,163,9185,53577454,Cataluña
6,221,7535,399,29,160,8123,53577454,Cataluña
6,222,6706,409,27,126,7268,53577454,Cataluña
6,223,7511,350,21,89,7971,53577454,Cataluña
6,224,8520,398,35,66,9019,53577454,Cataluña
6,225,9775,440,43,80,10338,53577454,Cataluña
6,226,8880,442,40,83,9445,53577454,Cataluña
6,227,10893,418,52,57,11420,53577454,Cataluña
6,228,12984,366,31,32,13413,53577454,Cataluña
6,229,7859,191,12,21,8083,53577454,Cataluña
7,1,0,0,0,0,0,1178989,Ceuta y Melilla
7,2,0,0,0,0,0,1178989,Ceuta y Melilla
7,3,0,0,0,0,0,1178989,Ceuta y Melilla
7,4,0,0,0,0,0,1178989,Ceuta y Melilla
7,5,0,0,0,0,0,1178989,Ceuta y Melilla
7,6,0,0,0,0,0,1178989,Ceuta y Melilla
7,7,0,0,0,0,0,1178989,Ceuta y Melilla
7,8,0,0,0,0,0,1178989,Ceuta y Melilla
7,9,1,0,0,0,1,1178989,Ceuta y Melilla
7,10,0,1,0,0,1,1178989,Ceuta y Melilla
7,11,21,4,0,0,25,1178989,Ceuta y Melilla
7,12,26,13,2,0,41,1178989,Ceuta y Melilla
7,13,66,24,4,2,96,1178989,Ceuta y Melilla
7,14,59,6,1,4,70,1178989,Ceuta y Melilla
7,15,23,4,0,0,27,1178989,Ceuta y Melilla
7,16,5,1,0,0,6,1178989,Ceuta y Melilla
7,17,12,1,0,0,13,1178989,Ceuta y Melilla
7,18,16,1,0,0,17,1178989,Ceuta y Melilla
7,19,6,0,0,0,6,1178989,Ceuta y Melilla
7,20,7,0,0,0,7,1178989,Ceuta y Melilla
7,21,9,2,0,0,11,1178989,Ceuta y Melilla
7,22,27,2,0,1,30,1178989,Ceuta y Melilla
7,23,7,0,0,0,7,1178989,Ceuta y Melilla
7,24,2,1,0,0,3,1178989,Ceuta y Melilla
7,25,2,0,0,0,2,1178989,Ceuta y Melilla
7,26,0,0,0,0,0,1178989,Ceuta y Melilla
7,27,0,0,0,0,0,1178989,Ceuta y Melilla
7,28,3,1,0,0,4,1178989,Ceuta y Melilla
7,29,1,0,0,0,1,1178989,Ceuta y Melilla
7,30,1,1,0,0,2,1178989,Ceuta y Melilla
7,31,16,0,0,0,16,1178989,Ceuta y Melilla
7,32,37,4,0,0,41,1178989,Ceuta y Melilla
7,33,45,5,0,0,50,1178989,Ceuta y Melilla
7,34,126,5,1,0,132,1178989,Ceuta y Melilla
7,35,146,10,1,1,158,1178989,Ceuta y Melilla
7,36,182,10,1,2,195,1178989,Ceuta y Melilla
7,37,205,13,3,3,224,1178989,Ceuta y Melilla
7,38,194,16,1,2,213,1178989,Ceuta y Melilla
7,39,250,10,1,1,262,1178989,Ceuta y Melilla
7,40,236,13,1,2,252,1178989,Ceuta y Melilla
7,41,330,24,1,5,360,1178989,Ceuta y Melilla
7,42,555,32,5,2,594,1178989,Ceuta y Melilla
7,43,734,50,3,3,790,1178989,Ceuta y Melilla
7,44,697,39,12,19,767,1178989,Ceuta y Melilla
7,45,374,28,6,8,416,1178989,Ceuta y Melilla
7,46,251,16,4,6,277,1178989,Ceuta y Melilla
7,47,225,16,2,3,246,1178989,Ceuta y Melilla
7,48,124,9,3,3,139,1178989,Ceuta y Melilla
7,49,83,13,0,1,97,1178989,Ceuta y Melilla
7,50,128,6,1,0,135,1178989,Ceuta y Melilla
7,51,100,6,1,1,108,1178989,Ceuta y Melilla
7,52,155,6,1,0,162,1178989,Ceuta y Melilla
7,53,75,0,0,2,77,336854,Ceuta y Melilla
7,213,330,16,1,1,348,1178989,Ceuta y Melilla
7,214,510,24,6,3,543,1178989,Ceuta y Melilla
7,215,688,42,6,6,742,1178989,Ceuta y Melilla
7,216,689,48,9,6,752,1178989,Ceuta y Melilla
7,217,592,32,6,6,636,1178989,Ceuta y Melilla
7,218,452,28,5,8,493,1178989,Ceuta y Melilla
7,219,317,11,4,6,338,1178989,Ceuta y Melilla
7,220,238,14,2,11,265,1178989,Ceuta y Melilla
7,221,333,20,5,6,364,1178989,Ceuta y Melilla
7,222,289,18,7,3,317,1178989,Ceuta y Melilla
7,223,361,37,5,4,407,1178989,Ceuta y Melilla
7,224,297,31,9,5,342,1178989,Ceuta y Melilla
7,225,347,32,4,6,389,1178989,Ceuta y Melilla
7,226,487,44,5,6,542,1178989,Ceuta y Melilla
7,227,390,56,6,4,456,1178989,Ceuta y Melilla
7,228,291,25,7,4,327,1178989,Ceuta y Melilla
7,229,179,5,0,2,186,1178989,Ceuta y Melilla
8,1,0,25,2,0,27,47259366,Comunidad de Madrid
8,2,0,14,0,0,14,47259366,Comunidad de Madrid
8,3,1,21,1,0,23,47259366,Comunidad de Madrid
8,4,0,20,1,0,21,47259366,Comunidad de Madrid
8,5,0,28,0,0,28,47259366,Comunidad de Madrid
8,6,0,33,5,0,38,47259366,Comunidad de Madrid
8,7,1,48,6,0,55,47259366,Comunidad de Madrid
8,8,1,98,8,0,107,47259366,Comunidad de Madrid
8,9,120,282,24,1,427,47259366,Comunidad de Madrid
8,10,1831,1575,149,49,3604,47259366,Comunidad de Madrid
8,11,7896,5339,500,473,14208,47259366,Comunidad de Madrid
8,12,16365,11094,843,1519,29821,47259366,Comunidad de Madrid
8,13,15129,8762,607,1931,26429,47259366,Comunidad de Madrid
8,14,9794,5297,380,1402,16873,47259366,Comunidad de Madrid
8,15,6277,3000,208,1004,10489,47259366,Comunidad de Madrid
8,16,4578,1611,122,736,7047,47259366,Comunidad de Madrid
8,17,3462,797,90,468,4817,47259366,Comunidad de Madrid
8,18,1914,433,40,320,2707,47259366,Comunidad de Madrid
8,19,1394,331,32,244,2001,47259366,Comunidad de Madrid
8,20,1102,227,26,146,1501,47259366,Comunidad de Madrid
8,21,859,188,18,144,1209,47259366,Comunidad de Madrid
8,22,869,147,14,99,1129,47259366,Comunidad de Madrid
8,23,824,108,15,79,1026,47259366,Comunidad de Madrid
8,24,696,106,12,64,878,47259366,Comunidad de Madrid
8,25,486,105,9,45,645,47259366,Comunidad de Madrid
8,26,345,71,10,22,448,47259366,Comunidad de Madrid
8,27,296,57,0,4,357,47259366,Comunidad de Madrid
8,28,332,59,2,1,394,47259366,Comunidad de Madrid
8,29,693,82,2,4,781,47259366,Comunidad de Madrid
8,30,1791,207,11,2,2011,47259366,Comunidad de Madrid
8,31,3864,432,16,8,4320,47259366,Comunidad de Madrid
8,32,7490,897,56,20,8463,47259366,Comunidad de Madrid
8,33,12915,1509,79,51,14554,47259366,Comunidad de Madrid
8,34,17508,2078,123,74,19783,47259366,Comunidad de Madrid
8,35,18841,2103,133,94,21171,47259366,Comunidad de Madrid
8,36,22630,2361,139,136,25266,47259366,Comunidad de Madrid
8,37,29193,3040,160,177,32570,47259366,Comunidad de Madrid
8,38,30083,3115,176,240,33614,47259366,Comunidad de Madrid
8,39,24444,2550,170,287,27451,47259366,Comunidad de Madrid
8,40,18516,2038,144,256,20954,47259366,Comunidad de Madrid
8,41,14371,1757,99,232,16459,47259366,Comunidad de Madrid
8,42,15636,1791,125,198,17750,47259366,Comunidad de Madrid
8,43,14272,1634,109,225,16240,47259366,Comunidad de Madrid
8,44,11456,1289,85,203,13033,47259366,Comunidad de Madrid
8,45,11754,1122,104,193,13173,47259366,Comunidad de Madrid
8,46,10069,1078,68,182,11397,47259366,Comunidad de Madrid
8,47,8031,853,58,100,9042,47259366,Comunidad de Madrid
8,48,7713,754,70,119,8656,47259366,Comunidad de Madrid
8,49,5772,707,52,88,6619,47259366,Comunidad de Madrid
8,50,12006,942,74,95,13117,47259366,Comunidad de Madrid
8,51,13285,1033,76,99,14493,47259366,Comunidad de Madrid
8,52,13423,975,73,119,14590,47259366,Comunidad de Madrid
8,53,6139,335,20,31,6525,13502676,Comunidad de Madrid
8,213,21016,1589,128,144,22877,47259366,Comunidad de Madrid
8,214,27381,1788,147,170,29486,47259366,Comunidad de Madrid
8,215,35148,2619,205,328,38300,47259366,Comunidad de Madrid
8,216,33202,2393,167,379,36141,47259366,Comunidad de Madrid
8,217,25298,2039,143,346,27826,47259366,Comunidad de Madrid
8,218,17154,1591,119,287,19151,47259366,Comunidad de Madrid
8,219,11902,1151,97,262,13412,47259366,Comunidad de Madrid
8,220,9123,865,81,196,10265,47259366,Comunidad de Madrid
8,221,7958,771,72,147,8948,47259366,Comunidad de Madrid
8,222,7680,773,73,127,8653,47259366,Comunidad de Madrid
8,223,8625,809,77,107,9618,47259366,Comunidad de Madrid
8,224,8645,817,86,74,9622,47259366,Comunidad de Madrid
8,225,10565,935,102,100,11702,47259366,Comunidad de Madrid
8,226,12673,1189,122,90,14074,47259366,Comunidad de Madrid
8,227,13768,1130,129,109,15136,47259366,Comunidad de Madrid
8,228,13969,1153,117,100,15339,47259366,Comunidad de Madrid
8,229,10011,403,38,73,10525,47259366,Comunidad de Madrid
9,1,0,0,0,0,0,4598034,Comunidad Foral de Navarra
9,2,0,1,0,0,1,4598034,Comunidad Foral de Navarra
9,3,0,1,0,0,1,4598034,Comunidad Foral de Navarra
9,4,0,2,0,0,2,4598034,Comunidad Foral de Navarra
9,5,0,1,0,0,1,4598034,Comunidad Foral de Navarra
9,6,0,3,0,0,3,4598034,Comunidad Foral de Navarra
9,7,0,2,0,0,2,4598034,Comunidad Foral de Navarra
9,8,0,6,1,0,7,4598034,Comunidad Foral de Navarra
9,9,3,8,1,0,12,4598034,Comunidad Foral de Navarra
9,10,48,29,3,0,80,4598034,Comunidad Foral de Navarra
9,11,363,187,10,4,564,4598034,Comunidad Foral de Navarra
9,12,871,519,47,42,1479,4598034,Comunidad Foral de Navarra
9,13,1242,623,43,106,2014,4598034,Comunidad Foral de Navarra
9,14,1000,391,22,104,1517,4598034,Comunidad Foral de Navarra
9,15,731,198,3,105,1037,4598034,Comunidad Foral de Navarra
9,16,387,121,6,79,593,4598034,Comunidad Foral de Navarra
9,17,297,51,4,43,395,4598034,Comunidad Foral de Navarra
9,18,164,35,2,24,225,4598034,Comunidad Foral de Navarra
9,19,126,25,0,16,167,4598034,Comunidad Foral de Navarra
9,20,105,16,1,2,124,4598034,Comunidad Foral de Navarra
9,21,60,11,0,2,73,4598034,Comunidad Foral de Navarra
9,22,51,15,1,1,68,4598034,Comunidad Foral de Navarra
9,23,39,6,0,0,45,4598034,Comunidad Foral de Navarra
9,24,18,2,0,0,20,4598034,Comunidad Foral de Navarra
9,25,68,2,1,0,71,4598034,Comunidad Foral de Navarra
9,26,42,2,0,0,44,4598034,Comunidad Foral de Navarra
9,27,26,4,0,0,30,4598034,Comunidad Foral de Navarra
9,28,135,3,0,0,138,4598034,Comunidad Foral de Navarra
9,29,460,6,0,1,467,4598034,Comunidad Foral de Navarra
9,30,476,19,0,0,495,4598034,Comunidad Foral de Navarra
9,31,439,21,2,0,462,4598034,Comunidad Foral de Navarra
9,32,705,30,5,2,742,4598034,Comunidad Foral de Navarra
9,33,629,35,4,1,669,4598034,Comunidad Foral de Navarra
9,34,787,40,7,1,835,4598034,Comunidad Foral de Navarra
9,35,1147,59,3,3,1212,4598034,Comunidad Foral de Navarra
9,36,1317,94,6,4,1421,4598034,Comunidad Foral de Navarra
9,37,2141,117,8,10,2276,4598034,Comunidad Foral de Navarra
9,38,2181,133,12,17,2343,4598034,Comunidad Foral de Navarra
9,39,2284,102,8,14,2408,4598034,Comunidad Foral de Navarra
9,40,1962,145,11,24,2142,4598034,Comunidad Foral de Navarra
9,41,3151,171,15,25,3362,4598034,Comunidad Foral de Navarra
9,42,3626,186,20,40,3872,4598034,Comunidad Foral de Navarra
9,43,4051,262,23,32,4368,4598034,Comunidad Foral de Navarra
9,44,3622,252,33,39,3946,4598034,Comunidad Foral de Navarra
9,45,2065,153,25,45,2288,4598034,Comunidad Foral de Navarra
9,46,1305,143,13,38,1499,4598034,Comunidad Foral de Navarra
9,47,913,61,9,45,1028,4598034,Comunidad Foral de Navarra
9,48,724,53,5,30,812,4598034,Comunidad Foral de Navarra
9,49,618,46,5,22,691,4598034,Comunidad Foral de Navarra
9,50,677,63,5,20,765,4598034,Comunidad Foral de Navarra
9,51,576,41,5,19,641,4598034,Comunidad Foral de Navarra
9,52,693,54,8,12,767,4598034,Comunidad Foral de Navarra
9,53,291,22,1,7,321,1313724,Comunidad Foral de Navarra
9,213,918,51,5,7,981,4598034,Comunidad Foral de Navarra
9,214,1318,60,7,11,1396,4598034,Comunidad Foral de Navarra
9,215,1643,125,15,14,1797,4598034,Comunidad Foral de Navarra
9,216,1610,94,15,28,1747,4598034,Comunidad Foral de Navarra
9,217,1437,82,9,13,1541,4598034,Comunidad Foral de Navarra
9,218,785,63,6,26,880,4598034,Comunidad Foral de Navarra
9,219,463,55,7,10,535,4598034,Comunidad Foral de Navarra
9,220,446,25,4,7,482,4598034,Comunidad Foral de Navarra
9,221,380,28,5,6,419,4598034,Comunidad Foral de Navarra
9,222,434,31,4,5,474,4598034,Comunidad Foral de Navarra
9,223,516,37,10,4,567,4598034,Comunidad Foral de Navarra
9,224,947,53,11,4,1015,4598034,Comunidad Foral de Navarra
9,225,1135,80,9,5,1229,4598034,Comunidad Foral de Navarra
9,226,1486,102,19,6,1613,4598034,Comunidad Foral de Navarra
9,227,1471,107,19,12,1609,4598034,Comunidad Foral de Navarra
9,228,1188,110,15,6,1319,4598034,Comunidad Foral de Navarra
9,229,927,82,12,12,1033,4598034,Comunidad Foral de Navarra
10,1,0,13,0,0,13,35229747,Comunidad Valenciana
10,2,0,12,0,0,12,35229747,Comunidad Valenciana
10,3,0,4,0,0,4,35229747,Comunidad Valenciana
10,4,0,6,0,0,6,35229747,Comunidad Valenciana
10,5,0,5,0,0,5,35229747,Comunidad Valenciana
10,6,0,3,0,0,3,35229747,Comunidad Valenciana
10,7,0,5,1,1,7,35229747,Comunidad Valenciana
10,8,0,13,4,0,17,35229747,Comunidad Valenciana
10,9,26,22,1,0,49,35229747,Comunidad Valenciana
10,10,74,61,5,0,140,35229747,Comunidad Valenciana
10,11,808,397,69,20,1294,35229747,Comunidad Valenciana
10,12,2239,1667,237,148,4291,35229747,Comunidad Valenciana
10,13,3449,1816,253,313,5831,35229747,Comunidad Valenciana
10,14,1842,776,86,334,3038,35229747,Comunidad Valenciana
10,15,1230,498,40,230,1998,35229747,Comunidad Valenciana
10,16,653,238,17,144,1052,35229747,Comunidad Valenciana
10,17,450,135,9,98,692,35229747,Comunidad Valenciana
10,18,380,103,6,58,547,35229747,Comunidad Valenciana
10,19,219,64,3,46,332,35229747,Comunidad Valenciana
10,20,171,28,3,28,230,35229747,Comunidad Valenciana
10,21,144,12,2,16,174,35229747,Comunidad Valenciana
10,22,109,7,0,7,123,35229747,Comunidad Valenciana
10,23,104,10,0,4,118,35229747,Comunidad Valenciana
10,24,72,6,1,3,82,35229747,Comunidad Valenciana
10,25,78,9,2,2,91,35229747,Comunidad Valenciana
10,26,93,9,0,3,105,35229747,Comunidad Valenciana
10,27,118,16,1,0,135,35229747,Comunidad Valenciana
10,28,143,20,2,0,165,35229747,Comunidad Valenciana
10,29,505,41,1,1,548,35229747,Comunidad Valenciana
10,30,882,60,4,3,949,35229747,Comunidad Valenciana
10,31,1607,108,10,4,1729,35229747,Comunidad Valenciana
10,32,2092,172,11,5,2280,35229747,Comunidad Valenciana
10,33,2801,226,19,9,3055,35229747,Comunidad Valenciana
10,34,3714,255,21,18,4008,35229747,Comunidad Valenciana
10,35,4328,299,37,28,4692,35229747,Comunidad Valenciana
10,36,4045,309,38,37,4429,35229747,Comunidad Valenciana
10,37,3917,320,27,33,4297,35229747,Comunidad Valenciana
10,38,3303,288,40,40,3671,35229747,Comunidad Valenciana
10,39,2851,234,26,31,3142,35229747,Comunidad Valenciana
10,40,3219,253,25,26,3523,35229747,Comunidad Valenciana
10,41,3358,345,34,40,3777,35229747,Comunidad Valenciana
10,42,6463,541,62,51,7117,35229747,Comunidad Valenciana
10,43,9954,790,63,60,10867,35229747,Comunidad Valenciana
10,44,11546,881,81,99,12607,35229747,Comunidad Valenciana
10,45,12649,1077,106,129,13961,35229747,Comunidad Valenciana
10,46,11042,1005,113,161,12321,35229747,Comunidad Valenciana
10,47,8938,789,97,156,9980,35229747,Comunidad Valenciana
10,48,6831,654,70,147,7702,35229747,Comunidad Valenciana
10,49,5970,520,56,112,6658,35229747,Comunidad Valenciana
10,50,10391,727,63,149,11330,35229747,Comunidad Valenciana
10,51,14261,965,76,131,15433,35229747,Comunidad Valenciana
10,52,15742,1191,108,210,17251,35229747,Comunidad Valenciana
10,53,7487,404,31,79,8001,10065642,Comunidad Valenciana
10,213,25696,1721,128,315,27860,35229747,Comunidad Valenciana
10,214,46166,2572,230,420,49388,35229747,Comunidad Valenciana
10,215,51866,3539,255,661,56321,35229747,Comunidad Valenciana
10,216,40716,3116,227,835,44894,35229747,Comunidad Valenciana
10,217,26122,2085,185,663,29055,35229747,Comunidad Valenciana
10,218,11036,1059,108,465,12668,35229747,Comunidad Valenciana
10,219,4805,495,52,284,5636,35229747,Comunidad Valenciana
10,220,2618,293,31,172,3114,35229747,Comunidad Valenciana
10,221,1598,172,17,74,1861,35229747,Comunidad Valenciana
10,222,1095,118,18,64,1295,35229747,Comunidad Valenciana
10,223,836,83,14,35,968,35229747,Comunidad Valenciana
10,224,746,110,12,17,885,35229747,Comunidad Valenciana
10,225,993,92,14,9,1108,35229747,Comunidad Valenciana
10,226,871,91,10,15,987,35229747,Comunidad Valenciana
10,227,1075,85,7,7,1174,35229747,Comunidad Valenciana
10,228,1065,93,13,6,1177,35229747,Comunidad Valenciana
10,229,970,60,4,6,1040,35229747,Comunidad Valenciana
11,1,0,0,0,0,0,7424550,Extremadura
11,2,0,0,0,0,0,7424550,Extremadura
11,3,0,0,0,0,0,7424550,Extremadura
11,4,0,0,0,0,0,7424550,Extremadura
11,5,0,0,0,0,0,7424550,Extremadura
11,6,0,0,0,0,0,7424550,Extremadura
11,7,0,2,0,0,2,7424550,Extremadura
11,8,0,1,0,0,1,7424550,Extremadura
11,9,8,4,1,0,13,7424550,Extremadura
11,10,6,14,1,0,21,7424550,Extremadura
11,11,236,56,8,6,306,7424550,Extremadura
11,12,570,318,31,44,963,7424550,Extremadura
11,13,860,354,36,120,1370,7424550,Extremadura
11,14,420,204,20,109,753,7424550,Extremadura
11,15,339,114,7,78,538,7424550,Extremadura
11,16,217,97,4,49,367,7424550,Extremadura
11,17,239,72,1,42,354,7424550,Extremadura
11,18,101,42,1,19,163,7424550,Extremadura
11,19,113,30,1,24,168,7424550,Extremadura
11,20,40,17,1,11,69,7424550,Extremadura
11,21,30,5,0,5,40,7424550,Extremadura
11,22,15,7,0,4,26,7424550,Extremadura
11,23,10,1,0,1,12,7424550,Extremadura
11,24,10,1,0,1,12,7424550,Extremadura
11,25,26,1,0,0,27,7424550,Extremadura
11,26,19,1,0,0,20,7424550,Extremadura
11,27,41,1,0,0,42,7424550,Extremadura
11,28,127,3,1,0,131,7424550,Extremadura
11,29,82,4,1,0,87,7424550,Extremadura
11,30,53,9,2,0,64,7424550,Extremadura
11,31,131,4,1,1,137,7424550,Extremadura
11,32,187,7,0,2,196,7424550,Extremadura
11,33,336,22,2,1,361,7424550,Extremadura
11,34,554,26,4,3,587,7424550,Extremadura
11,35,654,32,5,3,694,7424550,Extremadura
11,36,949,53,4,9,1015,7424550,Extremadura
11,37,1420,90,8,3,1521,7424550,Extremadura
11,38,1662,130,7,25,1824,7424550,Extremadura
11,39,1269,113,7,28,1417,7424550,Extremadura
11,40,1137,59,3,38,1237,7424550,Extremadura
11,41,1356,98,8,23,1485,7424550,Extremadura
11,42,2076,123,6,24,2229,7424550,Extremadura
11,43,3047,221,16,40,3324,7424550,Extremadura
11,44,3066,237,20,57,3380,7424550,Extremadura
11,45,2983,230,29,55,3297,7424550,Extremadura
11,46,1853,142,9,53,2057,7424550,Extremadura
11,47,1284,111,9,47,1451,7424550,Extremadura
11,48,1045,92,13,48,1198,7424550,Extremadura
11,49,812,59,6,31,908,7424550,Extremadura
11,50,1466,62,5,20,1553,7424550,Extremadura
11,51,2213,133,4,18,2368,7424550,Extremadura
11,52,2885,107,10,26,3028,7424550,Extremadura
11,53,1481,37,2,10,1530,2121300,Extremadura
11,213,5376,243,19,49,5687,7424550,Extremadura
11,214,8262,345,25,81,8713,7424550,Extremadura
11,215,7734,467,47,111,8359,7424550,Extremadura
11,216,5126,452,42,142,5762,7424550,Extremadura
11,217,2472,264,29,112,2877,7424550,Extremadura
11,218,991,114,13,80,1198,7424550,Extremadura
11,219,447,63,7,34,551,7424550,Extremadura
11,220,273,31,5,21,330,7424550,Extremadura
11,221,205,18,2,13,238,7424550,Extremadura
11,222,288,20,1,10,319,7424550,Extremadura
11,223,547,31,2,3,583,7424550,Extremadura
11,224,462,39,3,4,508,7424550,Extremadura
11,225,692,45,7,4,748,7424550,Extremadura
11,226,701,50,5,2,758,7424550,Extremadura
11,227,757,62,2,13,834,7424550,Extremadura
11,228,629,55,7,6,697,7424550,Extremadura
11,229,426,34,4,7,471,7424550,Extremadura
12,1,0,1,0,0,1,18904644.5,Galicia
12,2,0,1,1,0,2,18904644.5,Galicia
12,3,0,2,1,0,3,18904644.5,Galicia
12,4,0,5,0,0,5,18904644.5,Galicia
12,5,0,0,0,0,0,18904644.5,Galicia
12,6,0,3,1,0,4,18904644.5,Galicia
12,7,0,2,0,0,2,18904644.5,Galicia
12,8,0,4,1,0,5,18904644.5,Galicia
12,9,1,7,0,0,8,18904644.5,Galicia
12,10,40,25,4,0,69,18904644.5,Galicia
12,11,411,121,16,5,553,18904644.5,Galicia
12,12,1772,602,77,26,2477,18904644.5,Galicia
12,13,2736,854,99,104,3793,18904644.5,Galicia
12,14,1796,507,50,162,2515,18904644.5,Galicia
12,15,1101,280,24,120,1525,18904644.5,Galicia
12,16,574,170,13,84,841,18904644.5,Galicia
12,17,384,102,11,52,549,18904644.5,Galicia
12,18,204,65,9,37,315,18904644.5,Galicia
12,19,125,61,5,11,202,18904644.5,Galicia
12,20,54,12,2,7,75,18904644.5,Galicia
12,21,52,7,1,6,66,18904644.5,Galicia
12,22,16,9,0,3,28,18904644.5,Galicia
12,23,14,2,0,0,16,18904644.5,Galicia
12,24,9,2,0,1,12,18904644.5,Galicia
12,25,15,2,0,0,17,18904644.5,Galicia
12,26,50,4,0,0,54,18904644.5,Galicia
12,27,149,5,0,0,154,18904644.5,Galicia
12,28,96,7,2,0,105,18904644.5,Galicia
12,29,75,10,1,0,86,18904644.5,Galicia
12,30,126,11,1,0,138,18904644.5,Galicia
12,31,216,14,1,0,231,18904644.5,Galicia
12,32,586,38,3,3,630,18904644.5,Galicia
12,33,964,71,9,3,1047,18904644.5,Galicia
12,34,1650,109,10,8,1777,18904644.5,Galicia
12,35,1857,153,9,12,2031,18904644.5,Galicia
12,36,1747,163,17,21,1948,18904644.5,Galicia
12,37,1596,174,14,30,1814,18904644.5,Galicia
12,38,1715,155,23,24,1917,18904644.5,Galicia
12,39,1353,112,16,22,1503,18904644.5,Galicia
12,40,1492,144,18,27,1681,18904644.5,Galicia
12,41,2259,177,21,31,2488,18904644.5,Galicia
12,42,2768,287,28,43,3126,18904644.5,Galicia
12,43,4269,330,47,45,4691,18904644.5,Galicia
12,44,4644,419,51,69,5183,18904644.5,Galicia
12,45,4070,380,47,72,4569,18904644.5,Galicia
12,46,3873,323,54,70,4320,18904644.5,Galicia
12,47,3517,260,42,81,3900,18904644.5,Galicia
12,48,2562,243,21,59,2885,18904644.5,Galicia
12,49,2216,225,25,51,2517,18904644.5,Galicia
12,50,2475,235,31,34,2775,18904644.5,Galicia
12,51,2464,226,28,23,2741,18904644.5,Galicia
12,52,2625,255,33,38,2951,18904644.5,Galicia
12,53,1125,79,10,13,1227,5401327,Galicia
12,213,3831,275,38,34,4178,18904644.5,Galicia
12,214,6915,496,74,57,7542,18904644.5,Galicia
12,215,10401,753,114,99,11367,18904644.5,Galicia
12,216,11324,995,141,156,12616,18904644.5,Galicia
12,217,8069,829,160,179,9237,18904644.5,Galicia
12,218,4682,595,93,140,5510,18904644.5,Galicia
12,219,2647,344,49,84,3124,18904644.5,Galicia
12,220,1878,240,42,56,2216,18904644.5,Galicia
12,221,1190,192,32,44,1458,18904644.5,Galicia
12,222,1066,139,27,26,1258,18904644.5,Galicia
12,223,1098,131,21,26,1276,18904644.5,Galicia
12,224,895,105,11,16,1027,18904644.5,Galicia
12,225,989,122,17,13,1141,18904644.5,Galicia
12,226,1017,102,16,24,1159,18904644.5,Galicia
12,227,1319,124,15,6,1464,18904644.5,Galicia
12,228,1407,137,29,9,1582,18904644.5,Galicia
12,229,1060,103,16,6,1185,18904644.5,Galicia
13,1,0,0,0,0,0,8490643,Islas Baleares
13,2,0,0,0,0,0,8490643,Islas Baleares
13,3,0,0,0,0,0,8490643,Islas Baleares
13,4,0,0,0,0,0,8490643,Islas Baleares
13,5,0,0,0,0,0,8490643,Islas Baleares
13,6,1,1,0,0,2,8490643,Islas Baleares
13,7,0,0,0,0,0,8490643,Islas Baleares
13,8,0,1,0,0,1,8490643,Islas Baleares
13,9,9,4,0,0,13,8490643,Islas Baleares
13,10,33,17,5,0,55,8490643,Islas Baleares
13,11,142,67,14,4,227,8490643,Islas Baleares
13,12,503,238,55,18,814,8490643,Islas Baleares
13,13,549,347,51,39,986,8490643,Islas Baleares
13,14,410,233,28,41,712,8490643,Islas Baleares
13,15,159,98,6,42,305,8490643,Islas Baleares
13,16,122,79,6,33,240,8490643,Islas Baleares
13,17,42,20,0,20,82,8490643,Islas Baleares
13,18,39,22,2,11,74,8490643,Islas Baleares
13,19,35,8,1,10,54,8490643,Islas Baleares
13,20,73,8,1,5,87,8490643,Islas Baleares
13,21,40,3,0,3,46,8490643,Islas Baleares
13,22,35,1,0,0,36,8490643,Islas Baleares
13,23,18,1,0,0,19,8490643,Islas Baleares
13,24,29,2,0,0,31,8490643,Islas Baleares
13,25,27,1,0,0,28,8490643,Islas Baleares
13,26,34,2,1,1,38,8490643,Islas Baleares
13,27,22,1,0,1,24,8490643,Islas Baleares
13,28,32,2,0,1,35,8490643,Islas Baleares
13,29,54,5,0,1,60,8490643,Islas Baleares
13,30,173,10,2,0,185,8490643,Islas Baleares
13,31,522,20,0,0,542,8490643,Islas Baleares
13,32,1214,34,6,1,1255,8490643,Islas Baleares
13,33,1967,66,15,4,2052,8490643,Islas Baleares
13,34,2045,112,17,10,2184,8490643,Islas Baleares
13,35,1821,114,26,23,1984,8490643,Islas Baleares
13,36,1225,128,12,17,1382,8490643,Islas Baleares
13,37,985,112,18,19,1134,8490643,Islas Baleares
13,38,1160,96,20,27,1303,8490643,Islas Baleares
13,39,844,56,3,15,918,8490643,Islas Baleares
13,40,705,51,4,16,776,8490643,Islas Baleares
13,41,764,57,9,12,842,8490643,Islas Baleares
13,42,984,46,4,10,1044,8490643,Islas Baleares
13,43,1436,81,11,9,1537,8490643,Islas Baleares
13,44,1528,90,16,11,1645,8490643,Islas Baleares
13,45,1551,107,16,12,1686,8490643,Islas Baleares
13,46,1358,92,15,17,1482,8490643,Islas Baleares
13,47,1131,69,15,10,1225,8490643,Islas Baleares
13,48,1283,64,8,9,1364,8490643,Islas Baleares
13,49,1506,72,10,12,1600,8490643,Islas Baleares
13,50,2413,135,19,20,2587,8490643,Islas Baleares
13,51,3556,173,12,26,3767,8490643,Islas Baleares
13,52,3090,218,35,26,3369,8490643,Islas Baleares
13,53,1130,41,11,8,1190,2425898,Islas Baleares
13,213,3467,164,33,25,3689,8490643,Islas Baleares
13,214,4483,219,37,40,4779,8490643,Islas Baleares
13,215,4283,259,34,40,4616,8490643,Islas Baleares
13,216,3277,233,39,39,3588,8490643,Islas Baleares
13,217,1776,143,32,46,1997,8490643,Islas Baleares
13,218,945,92,19,32,1088,8490643,Islas Baleares
13,219,692,46,4,23,765,8490643,Islas Baleares
13,220,426,46,2,10,484,8490643,Islas Baleares
13,221,309,23,4,7,343,8490643,Islas Baleares
13,222,270,29,5,5,309,8490643,Islas Baleares
13,223,279,14,3,3,299,8490643,Islas Baleares
13,224,380,16,2,0,398,8490643,Islas Baleares
13,225,452,20,0,1,473,8490643,Islas Baleares
13,226,353,14,5,0,372,8490643,Islas Baleares
13,227,395,22,2,1,420,8490643,Islas Baleares
13,228,341,20,3,2,366,8490643,Islas Baleares
13,229,271,14,2,2,289,8490643,Islas Baleares
14,1,0,0,0,0,0,15685201,Islas Canarias
14,2,0,2,0,0,2,15685201,Islas Canarias
14,3,0,4,0,0,4,15685201,Islas Canarias
14,4,0,1,0,0,1,15685201,Islas Canarias
14,5,1,3,0,0,4,15685201,Islas Canarias
14,6,0,0,0,0,0,15685201,Islas Canarias
14,7,0,4,1,0,5,15685201,Islas Canarias
14,8,1,5,0,0,6,15685201,Islas Canarias
14,9,6,10,1,0,17,15685201,Islas Canarias
14,10,23,22,3,0,48,15685201,Islas Canarias
14,11,177,91,25,4,297,15685201,Islas Canarias
14,12,619,238,47,19,923,15685201,Islas Canarias
14,13,656,305,66,46,1073,15685201,Islas Canarias
14,14,351,134,17,27,529,15685201,Islas Canarias
14,15,158,75,7,12,252,15685201,Islas Canarias
14,16,112,31,6,18,167,15685201,Islas Canarias
14,17,86,16,2,14,118,15685201,Islas Canarias
14,18,35,13,0,8,56,15685201,Islas Canarias
14,19,36,14,4,6,60,15685201,Islas Canarias
14,20,35,9,1,5,50,15685201,Islas Canarias
14,21,25,8,1,3,37,15685201,Islas Canarias
14,22,28,7,1,3,39,15685201,Islas Canarias
14,23,13,10,1,0,24,15685201,Islas Canarias
14,24,9,5,0,1,15,15685201,Islas Canarias
14,25,35,4,0,0,39,15685201,Islas Canarias
14,26,8,5,0,0,13,15685201,Islas Canarias
14,27,10,5,1,0,16,15685201,Islas Canarias
14,28,22,13,2,0,37,15685201,Islas Canarias
14,29,89,9,0,0,98,15685201,Islas Canarias
14,30,50,7,0,0,57,15685201,Islas Canarias
14,31,93,14,0,0,107,15685201,Islas Canarias
14,32,380,23,1,2,406,15685201,Islas Canarias
14,33,820,72,13,2,907,15685201,Islas Canarias
14,34,1536,103,18,4,1661,15685201,Islas Canarias
14,35,2001,141,26,7,2175,15685201,Islas Canarias
14,36,1916,152,32,14,2114,15685201,Islas Canarias
14,37,1493,125,33,20,1671,15685201,Islas Canarias
14,38,1152,96,24,14,1286,15685201,Islas Canarias
14,39,1115,102,19,15,1251,15685201,Islas Canarias
14,40,943,94,22,5,1064,15685201,Islas Canarias
14,41,786,84,14,10,894,15685201,Islas Canarias
14,42,787,70,19,14,890,15685201,Islas Canarias
14,43,711,61,15,11,798,15685201,Islas Canarias
14,44,792,67,9,10,878,15685201,Islas Canarias
14,45,973,95,14,12,1094,15685201,Islas Canarias
14,46,797,86,13,13,909,15685201,Islas Canarias
14,47,828,76,12,14,930,15685201,Islas Canarias
14,48,872,89,15,12,988,15685201,Islas Canarias
14,49,1124,101,11,7,1243,15685201,Islas Canarias
14,50,1519,148,20,17,1704,15685201,Islas Canarias
14,51,1462,112,16,30,1620,15685201,Islas Canarias
14,52,1309,96,23,18,1446,15685201,Islas Canarias
14,53,536,29,4,9,578,4481486,Islas Canarias
14,213,1434,104,15,19,1572,15685201,Islas Canarias
14,214,2107,141,35,19,2302,15685201,Islas Canarias
14,215,1905,125,39,26,2095,15685201,Islas Canarias
14,216,1996,165,37,29,2227,15685201,Islas Canarias
14,217,1628,142,35,16,1821,15685201,Islas Canarias
14,218,1418,113,28,18,1577,15685201,Islas Canarias
14,219,1059,97,27,14,1197,15685201,Islas Canarias
14,220,1214,99,22,21,1356,15685201,Islas Canarias
14,221,1150,111,26,16,1303,15685201,Islas Canarias
14,222,1345,109,35,19,1508,15685201,Islas Canarias
14,223,1450,116,27,16,1609,15685201,Islas Canarias
14,224,1529,119,41,17,1706,15685201,Islas Canarias
14,225,1363,126,26,19,1534,15685201,Islas Canarias
14,226,1389,124,29,10,1552,15685201,Islas Canarias
14,227,1517,106,32,14,1669,15685201,Islas Canarias
14,228,1295,104,19,12,1430,15685201,Islas Canarias
14,229,874,54,4,6,938,15685201,Islas Canarias
15,1,0,0,0,0,0,2212252,La Rioja
15,2,0,0,0,0,0,2212252,La Rioja
15,3,0,0,0,0,0,2212252,La Rioja
15,4,0,0,0,0,0,2212252,La Rioja
15,5,0,0,0,0,0,2212252,La Rioja
15,6,0,0,0,0,0,2212252,La Rioja
15,7,0,1,0,0,1,2212252,La Rioja
15,8,2,1,0,0,3,2212252,La Rioja
15,9,7,4,0,0,11,2212252,La Rioja
15,10,172,18,1,2,193,2212252,La Rioja
15,11,282,90,15,4,391,2212252,La Rioja
15,12,615,198,25,40,878,2212252,La Rioja
15,13,1061,281,18,63,1423,2212252,La Rioja
15,14,881,214,10,88,1193,2212252,La Rioja
15,15,469,113,2,63,647,2212252,La Rioja
15,16,256,70,5,45,376,2212252,La Rioja
15,17,145,29,1,25,200,2212252,La Rioja
15,18,50,8,0,7,65,2212252,La Rioja
15,19,19,6,0,12,37,2212252,La Rioja
15,20,25,4,0,8,37,2212252,La Rioja
15,21,8,2,0,5,15,2212252,La Rioja
15,22,9,1,0,1,11,2212252,La Rioja
15,23,10,2,0,2,14,2212252,La Rioja
15,24,7,2,0,0,9,2212252,La Rioja
15,25,3,0,0,1,4,2212252,La Rioja
15,26,5,1,0,2,8,2212252,La Rioja
15,27,2,0,0,1,3,2212252,La Rioja
15,28,29,2,0,0,31,2212252,La Rioja
15,29,46,0,0,0,46,2212252,La Rioja
15,30,35,1,0,0,36,2212252,La Rioja
15,31,26,4,0,0,30,2212252,La Rioja
15,32,122,3,0,0,125,2212252,La Rioja
15,33,392,12,1,1,406,2212252,La Rioja
15,34,466,34,2,2,504,2212252,La Rioja
15,35,651,64,7,4,726,2212252,La Rioja
15,36,535,59,7,7,608,2212252,La Rioja
15,37,647,64,8,9,728,2212252,La Rioja
15,38,799,59,7,18,883,2212252,La Rioja
15,39,660,40,4,10,714,2212252,La Rioja
15,40,591,52,7,8,658,2212252,La Rioja
15,41,756,63,11,10,840,2212252,La Rioja
15,42,1035,91,13,5,1144,2212252,La Rioja
15,43,1216,118,11,16,1361,2212252,La Rioja
15,44,1238,117,17,18,1390,2212252,La Rioja
15,45,1280,117,11,23,1431,2212252,La Rioja
15,46,918,99,10,20,1047,2212252,La Rioja
15,47,667,57,10,17,751,2212252,La Rioja
15,48,524,67,6,17,614,2212252,La Rioja
15,49,307,34,5,16,362,2212252,La Rioja
15,50,328,30,3,4,365,2212252,La Rioja
15,51,388,36,0,7,431,2212252,La Rioja
15,52,419,30,4,7,460,2212252,La Rioja
15,53,331,15,2,0,348,632072,La Rioja
15,213,737,58,10,6,811,2212252,La Rioja
15,214,1585,117,17,12,1731,2212252,La Rioja
15,215,2224,162,21,13,2420,2212252,La Rioja
15,216,1984,174,28,21,2207,2212252,La Rioja
15,217,1360,142,32,30,1564,2212252,La Rioja
15,218,446,83,16,28,573,2212252,La Rioja
15,219,222,40,1,19,282,2212252,La Rioja
15,220,105,23,3,8,139,2212252,La Rioja
15,221,135,24,3,4,166,2212252,La Rioja
15,222,107,25,3,4,139,2212252,La Rioja
15,223,118,21,2,5,146,2212252,La Rioja
15,224,211,20,4,5,240,2212252,La Rioja
15,225,312,29,3,1,345,2212252,La Rioja
15,226,336,34,5,7,382,2212252,La Rioja
15,227,403,41,7,1,452,2212252,La Rioja
15,228,462,39,5,4,510,2212252,La Rioja
15,229,337,25,3,3,368,2212252,La Rioja
16,1,0,3,0,0,3,15325201.5,País Vasco
16,2,0,5,0,0,5,15325201.5,País Vasco
16,3,0,1,0,0,1,15325201.5,País Vasco
16,4,0,0,0,0,0,15325201.5,País Vasco
16,5,0,2,0,0,2,15325201.5,País Vasco
16,6,0,7,1,0,8,15325201.5,País Vasco
16,7,0,5,0,0,5,15325201.5,País Vasco
16,8,0,14,0,0,14,15325201.5,País Vasco
16,9,9,30,3,0,42,15325201.5,País Vasco
16,10,256,121,8,6,391,15325201.5,País Vasco
16,11,758,425,33,46,1262,15325201.5,País Vasco
16,12,2392,1435,87,135,4049,15325201.5,País Vasco
16,13,3585,1627,124,251,5587,15325201.5,País Vasco
16,14,2570,825,43,321,3759,15325201.5,País Vasco
16,15,1578,395,20,277,2270,15325201.5,País Vasco
16,16,973,172,7,179,1331,15325201.5,País Vasco
16,17,678,112,7,98,895,15325201.5,País Vasco
16,18,426,58,3,74,561,15325201.5,País Vasco
16,19,328,46,4,52,430,15325201.5,País Vasco
16,20,228,14,0,29,271,15325201.5,País Vasco
16,21,180,19,2,33,234,15325201.5,País Vasco
16,22,146,11,1,26,184,15325201.5,País Vasco
16,23,160,18,0,20,198,15325201.5,País Vasco
16,24,214,12,1,7,234,15325201.5,País Vasco
16,25,181,8,1,2,192,15325201.5,País Vasco
16,26,161,5,1,3,170,15325201.5,País Vasco
16,27,225,6,0,2,233,15325201.5,País Vasco
16,28,347,11,1,2,361,15325201.5,País Vasco
16,29,991,23,1,1,1016,15325201.5,País Vasco
16,30,1073,40,3,0,1116,15325201.5,País Vasco
16,31,1540,64,4,5,1613,15325201.5,País Vasco
16,32,2684,131,7,8,2830,15325201.5,País Vasco
16,33,3606,198,17,6,3827,15325201.5,País Vasco
16,34,4183,243,21,32,4479,15325201.5,País Vasco
16,35,4733,297,21,44,5095,15325201.5,País Vasco
16,36,4535,309,34,56,4934,15325201.5,País Vasco
16,37,3778,314,24,61,4177,15325201.5,País Vasco
16,38,3654,204,21,76,3955,15325201.5,País Vasco
16,39,3265,189,27,60,3541,15325201.5,País Vasco
16,40,2970,189,17,40,3216,15325201.5,País Vasco
16,41,3861,163,14,48,4086,15325201.5,País Vasco
16,42,5818,281,32,52,6183,15325201.5,País Vasco
16,43,8251,341,36,52,8680,15325201.5,País Vasco
16,44,9297,352,42,84,9775,15325201.5,País Vasco
16,45,9626,413,38,82,10159,15325201.5,País Vasco
16,46,7678,359,45,131,8213,15325201.5,País Vasco
16,47,5124,261,26,123,5534,15325201.5,País Vasco
16,48,3730,229,26,101,4086,15325201.5,País Vasco
16,49,2965,184,17,110,3276,15325201.5,País Vasco
16,50,3212,171,11,105,3499,15325201.5,País Vasco
16,51,2691,144,16,103,2954,15325201.5,País Vasco
16,52,2266,124,17,80,2487,15325201.5,País Vasco
16,53,897,39,2,17,955,4378629,País Vasco
16,213,2700,176,13,67,2956,15325201.5,País Vasco
16,214,4429,206,22,67,4724,15325201.5,País Vasco
16,215,5320,331,29,110,5790,15325201.5,País Vasco
16,216,6286,417,52,130,6885,15325201.5,País Vasco
16,217,5749,397,50,113,6309,15325201.5,País Vasco
16,218,4492,345,38,112,4987,15325201.5,País Vasco
16,219,3132,244,25,99,3500,15325201.5,País Vasco
16,220,2496,178,19,60,2753,15325201.5,País Vasco
16,221,2016,151,13,55,2235,15325201.5,País Vasco
16,222,1911,127,14,55,2107,15325201.5,País Vasco
16,223,2194,118,12,31,2355,15325201.5,País Vasco
16,224,2625,151,10,33,2819,15325201.5,País Vasco
16,225,3167,199,16,40,3422,15325201.5,País Vasco
16,226,4169,190,17,46,4422,15325201.5,País Vasco
16,227,5781,247,23,43,6094,15325201.5,País Vasco
16,228,5928,114,16,39,6097,15325201.5,País Vasco
16,229,4678,3,3,17,4701,15325201.5,País Vasco
17,1,0,0,0,0,0,7120151.5,Principado de Asturias
17,2,0,0,0,0,0,7120151.5,Principado de Asturias
17,3,0,1,0,0,1,7120151.5,Principado de Asturias
17,4,0,0,0,0,0,7120151.5,Principado de Asturias
17,5,0,1,0,0,1,7120151.5,Principado de Asturias
17,6,0,1,0,0,1,7120151.5,Principado de Asturias
17,7,0,2,0,0,2,7120151.5,Principado de Asturias
17,8,0,1,1,0,2,7120151.5,Principado de Asturias
17,9,3,5,1,0,9,7120151.5,Principado de Asturias
17,10,30,17,1,0,48,7120151.5,Principado de Asturias
17,11,240,59,7,1,307,7120151.5,Principado de Asturias
17,12,546,217,31,27,821,7120151.5,Principado de Asturias
17,13,557,298,45,46,946,7120151.5,Principado de Asturias
17,14,369,163,14,32,578,7120151.5,Principado de Asturias
17,15,360,166,15,67,608,7120151.5,Principado de Asturias
17,16,143,97,6,39,285,7120151.5,Principado de Asturias
17,17,54,43,3,48,148,7120151.5,Principado de Asturias
17,18,37,21,3,19,80,7120151.5,Principado de Asturias
17,19,35,8,2,15,60,7120151.5,Principado de Asturias
17,20,18,6,0,14,38,7120151.5,Principado de Asturias
17,21,5,1,0,5,11,7120151.5,Principado de Asturias
17,22,27,7,0,9,43,7120151.5,Principado de Asturias
17,23,6,4,0,9,19,7120151.5,Principado de Asturias
17,24,4,0,0,3,7,7120151.5,Principado de Asturias
17,25,0,0,0,2,2,7120151.5,Principado de Asturias
17,26,0,0,0,2,2,7120151.5,Principado de Asturias
17,27,2,0,0,1,3,7120151.5,Principado de Asturias
17,28,6,1,0,0,7,7120151.5,Principado de Asturias
17,29,6,2,0,0,8,7120151.5,Principado de Asturias
17,30,33,1,0,0,34,7120151.5,Principado de Asturias
17,31,92,0,1,0,93,7120151.5,Principado de Asturias
17,32,163,5,0,0,168,7120151.5,Principado de Asturias
17,33,172,4,0,0,176,7120151.5,Principado de Asturias
17,34,235,8,0,1,244,7120151.5,Principado de Asturias
17,35,245,24,4,0,273,7120151.5,Principado de Asturias
17,36,365,33,4,3,405,7120151.5,Principado de Asturias
17,37,411,30,4,3,448,7120151.5,Principado de Asturias
17,38,606,34,6,2,648,7120151.5,Principado de Asturias
17,39,630,68,5,4,707,7120151.5,Principado de Asturias
17,40,713,94,6,5,818,7120151.5,Principado de Asturias
17,41,1195,140,9,11,1355,7120151.5,Principado de Asturias
17,42,1525,221,11,17,1774,7120151.5,Principado de Asturias
17,43,2114,344,22,48,2528,7120151.5,Principado de Asturias
17,44,2284,455,36,72,2847,7120151.5,Principado de Asturias
17,45,3158,561,33,136,3888,7120151.5,Principado de Asturias
17,46,3468,576,34,134,4212,7120151.5,Principado de Asturias
17,47,2331,485,31,160,3007,7120151.5,Principado de Asturias
17,48,1547,324,15,141,2027,7120151.5,Principado de Asturias
17,49,1218,183,17,111,1529,7120151.5,Principado de Asturias
17,50,918,148,11,85,1162,7120151.5,Principado de Asturias
17,51,595,85,5,55,740,7120151.5,Principado de Asturias
17,52,568,76,5,36,685,7120151.5,Principado de Asturias
17,53,236,21,1,10,268,2034329,Principado de Asturias
17,213,903,83,9,28,1023,7120151.5,Principado de Asturias
17,214,1730,202,11,24,1967,7120151.5,Principado de Asturias
17,215,2492,299,15,57,2863,7120151.5,Principado de Asturias
17,216,3582,432,30,68,4112,7120151.5,Principado de Asturias
17,217,3004,464,38,76,3582,7120151.5,Principado de Asturias
17,218,340,218,23,54,635,7120151.5,Principado de Asturias
17,219,177,84,16,47,324,7120151.5,Principado de Asturias
17,220,168,54,5,39,266,7120151.5,Principado de Asturias
17,221,150,47,8,40,245,7120151.5,Principado de Asturias
17,222,127,49,5,13,194,7120151.5,Principado de Asturias
17,223,107,27,11,14,159,7120151.5,Principado de Asturias
17,224,97,26,3,14,140,7120151.5,Principado de Asturias
17,225,286,33,2,17,338,7120151.5,Principado de Asturias
17,226,829,61,6,17,913,7120151.5,Principado de Asturias
17,227,910,107,12,5,1034,7120151.5,Principado de Asturias
17,228,786,121,21,12,940,7120151.5,Principado de Asturias
17,229,599,74,9,5,687,7120151.5,Principado de Asturias
18,1,0,0,0,0,0,10549038.5,Región de Murcia
18,2,0,1,0,0,1,10549038.5,Región de Murcia
18,3,0,0,0,0,0,10549038.5,Región de Murcia
18,4,0,0,0,0,0,10549038.5,Región de Murcia
18,5,0,2,0,0,2,10549038.5,Región de Murcia
18,6,0,1,0,0,1,10549038.5,Región de Murcia
18,7,0,4,0,0,4,10549038.5,Región de Murcia
18,8,0,5,0,0,5,10549038.5,Región de Murcia
18,9,0,1,1,0,2,10549038.5,Región de Murcia
18,10,10,9,0,0,19,10549038.5,Región de Murcia
18,11,143,44,7,0,194,10549038.5,Región de Murcia
18,12,427,164,33,7,631,10549038.5,Región de Murcia
18,13,490,227,38,42,797,10549038.5,Región de Murcia
18,14,274,123,16,46,459,10549038.5,Región de Murcia
18,15,136,50,8,22,216,10549038.5,Región de Murcia
18,16,50,19,5,11,85,10549038.5,Región de Murcia
18,17,40,9,2,6,57,10549038.5,Región de Murcia
18,18,32,14,3,7,56,10549038.5,Región de Murcia
18,19,36,5,0,2,43,10549038.5,Región de Murcia
18,20,35,8,0,2,45,10549038.5,Región de Murcia
18,21,22,2,0,1,25,10549038.5,Región de Murcia
18,22,17,3,0,0,20,10549038.5,Región de Murcia
18,23,17,1,0,1,19,10549038.5,Región de Murcia
18,24,6,0,0,0,6,10549038.5,Región de Murcia
18,25,23,3,0,0,26,10549038.5,Región de Murcia
18,26,36,6,0,0,42,10549038.5,Región de Murcia
18,27,28,4,2,1,35,10549038.5,Región de Murcia
18,28,61,3,0,0,64,10549038.5,Región de Murcia
18,29,134,9,1,0,144,10549038.5,Región de Murcia
18,30,412,16,0,0,428,10549038.5,Región de Murcia
18,31,468,35,7,0,510,10549038.5,Región de Murcia
18,32,548,45,7,1,601,10549038.5,Región de Murcia
18,33,843,82,10,3,938,10549038.5,Región de Murcia
18,34,1509,136,16,3,1664,10549038.5,Región de Murcia
18,35,2047,181,22,2,2252,10549038.5,Región de Murcia
18,36,2562,221,36,9,2828,10549038.5,Región de Murcia
18,37,3241,216,25,25,3507,10549038.5,Región de Murcia
18,38,3223,201,22,12,3458,10549038.5,Región de Murcia
18,39,2996,217,37,18,3268,10549038.5,Región de Murcia
18,40,2841,232,31,11,3115,10549038.5,Región de Murcia
18,41,2719,240,28,29,3016,10549038.5,Región de Murcia
18,42,4009,318,42,24,4393,10549038.5,Región de Murcia
18,43,5447,385,46,47,5925,10549038.5,Región de Murcia
18,44,5778,408,43,68,6297,10549038.5,Región de Murcia
18,45,5947,427,56,83,6513,10549038.5,Región de Murcia
18,46,3869,362,57,66,4354,10549038.5,Región de Murcia
18,47,2026,213,21,65,2325,10549038.5,Región de Murcia
18,48,1408,141,25,31,1605,10549038.5,Región de Murcia
18,49,947,95,16,32,1090,10549038.5,Región de Murcia
18,50,1307,104,14,30,1455,10549038.5,Región de Murcia
18,51,1273,104,18,26,1421,10549038.5,Región de Murcia
18,52,1735,115,20,23,1893,10549038.5,Región de Murcia
18,53,1104,44,6,13,1167,3014011,Región de Murcia
18,213,5240,266,38,27,5571,10549038.5,Región de Murcia
18,214,12100,543,62,51,12756,10549038.5,Región de Murcia
18,215,11597,803,97,126,12623,10549038.5,Región de Murcia
18,216,8001,725,68,179,8973,10549038.5,Región de Murcia
18,217,3785,452,53,149,4439,10549038.5,Región de Murcia
18,218,1763,205,28,94,2090,10549038.5,Región de Murcia
18,219,1041,130,17,63,1251,10549038.5,Región de Murcia
18,220,704,90,9,47,850,10549038.5,Región de Murcia
18,221,570,71,12,28,681,10549038.5,Región de Murcia
18,222,489,65,11,16,581,10549038.5,Región de Murcia
18,223,426,57,8,6,497,10549038.5,Región de Murcia
18,224,430,41,7,5,483,10549038.5,Región de Murcia
18,225,513,45,5,14,577,10549038.5,Región de Murcia
18,226,549,55,7,3,614,10549038.5,Región de Murcia
18,227,488,43,7,4,542,10549038.5,Región de Murcia
18,228,530,44,6,5,585,10549038.5,Región de Murcia
18,229,411,42,3,1,457,10549038.5,Región de Murcia
